12345678901234567890123456789012
#########    ######    #########
##                            ##
##                            ##
##                            ##
##   ########      ########   ##
##   #                    #   ##
##   #                    #   ##
##   #                    #   ##
##   #                    #   ##
##   #########    #########   ##
##                            ##
##                            ##
##                            ##
##                            ##
##   ##########  ##########   ##
##                            ##
##                            ##
##                            ##
##                            ##
#########  ###    ###  #########
##                            ##
##                            ##
##                            ##
##                            ##
#########    ######    #########
